1111111111111111111
1C010000000C0D00001
10100111100000P0001
100011E00C000000011
1111111111111111111
