1111111111111111111
1C010000000C0000001
1000C1111000000P001
100011E0C0000000011
1111111111111111111
